NO ./path_to_the_north_texture.png
SO ./path_to_the_south_texture.png
EA ./path_to_the_east_texture.xmp
WE ./path_to_the_west_texture.png


F 220,100,0
C 225,30,0

111111111111
1N0000000101
100010001001
110000010001
101000100001
100101000001
100010000001
111111111111