NO ./textures/north.png
SO ./textures/south.png
EA ./textures/east.png
WE ./textures/west.png

F 220,100,0
C 225,30,0

00000000000000100000000
1111111111111101111111111111111111111111111111111111111111111111111111111111111111111111111111111111111111111111111111111111111111111111111111111111111111111111111111111111111111111111111111111111111111111111111111111111111111111111111111111111111111111111111111111111111111
1000100000000000100000000000011000000000000000111000000000000000100000000000000110000000000000000000000000001110000000000000000000111110000000000000000000000000000000000000000000000000001111111111111000000000000000000000000000011111110000000000001111110000000000000000000001
1000000000100N00000000011000000000000000111000000000000000100000000000000110000000001111100000000000000000011100000001000000000001111100000000000001000000011110000000000000000000000111110000000000000000000000000001100000000000000000000001100000000000001100000001110000000001
1000000000100000000000011000010000010000000110000001000000000100000001000000011000010000010000001000010000000011100000001010000001000110000000100000010001000011110000001000000000000110000010000000111000001000011000001100000010000000000110000000100000011000000010000010000101
1000000000000000000000000000011000000000000000111000000000000000100000000000000110000000000000000000000000001110000000000000000000000000000000000000000000000000000000000000000000000000000001111111111000000000000000000000000000011111110000000000001111110000000000000000000001
1000000000100000000000011000000000000000111000000000000000100000000000000110000000001111100000000000000000011100000001000000000001111100000000000001000000011110000000000000000000000111110000000000001111110000000001100000000000000000000001100000000000000000000001110000000001
1000000000100000100000011000010000010000000110000001000000000100000001000000011000010000010000001000010000000011100000001010000001000110000000100000010001000011110000001000000000000110000010000000111000001000011000001100000010000000000110000000100000011000000010000010000101
1000000000000001000000000000011000000000000000111000000000000000100000000000000110000000000000000000000000001110000000000000000000111110000000000000000000000000000000000000000000000000001111111111111000000000000000000000000000011111110000000000001111110000000000000000000001
1000000000100000000000011000000000000000111000000000000000100000000000000110000000001111100000000000000000011100000001000000000001111100000000000001000000011110000000000000000000000111110000000000001111110000000001100000000000000000000001100000000000001100000001110000000001
1000000000100000000000011000010000010000000110000001000000000100000001000000011000010000010000001000010000000011100000001010000001000110000000100000010001000011110000001000000000000110000010000000111000001000011000001100000010000000000110000000100000011000000010000010000101
1000000000000000000000000000011000000000000000111000000000000000100000000000000110000000000000000000000000001110000000000000000000111110000000000000000000000000000000000000000000000000001111111111111000000000000000000000000000011111110000000000001111110000000000000000000001
1000000000100000000000011000000000000000111000000000000000100000000000000110000000001111100000000000000000011100000001000000000001111100000000000001000000011110000000000000000000000111110000000000001111110000000001100000000000000000000001100000000000001100000001110000000001
1000000000100001000000011000010000010000000110000001000000000100000001000000011000010000010000001000010000000011100000001010000001000110000000100000010001000011110000001000000000000110000010000000111000001000011000001100000010000000000110000000100000011000000010000010000101
1000000000000000100000000000011000000000000000111000000000000000100000000000000110000000000000000000000000001110000000000000000000111110000000000000000000000000000000000000000000000000001111111111111000000000000000000000000000011111110000000000001111110000000000000000000001
1000000000100000000000011000000000000000111000000000000000100000000000000110000000001111100000000000000000011100000001000000000001111100000000000001000000011110000000000000000000000111110000000000001111110000000001100000000000000000000001100000000000001100000001110000000001
1000000000100001000000011000010000010000000110000001000000000100000001000000011000010000010000001000010000000000000000001010000001000110000000100000010001000011110000001000000000000110000010000000111000001000011000001100000010000000000110000000100000011000000010000010000101
1000000000000000100000000000011000000000000000111000000000000000100000000000000110000000000000000000000000001110000000000000000000111110000000000000000000000000000000000000000000000000001111111111111000000000000000000000000000011111110000000000001111110000000000000000000001
1000000000100000000000011000000000000000111000000000000000100000000000000110000000001111100000000000000000011100000001000000000001111100000000000001000000011110000000000000000000000111110000000000001111110000000001100000000000000000000001100000000000001100000001110000000001
1000000000100001000000011000010000010000000110000001000010000100000001000000011000010000010000001000010000000011100000001010000001000110000000100000010001000011110000001000000000000110000010000000111000001000011000001100000010000000000110000000100000011000000010000010000101
10000000000000001000000000000110000000000000001110000000100000000100000000000000110000000000000000000000000001110000000000000000000111110000000000000000000000000000000000000000000000000001111111111111000000000000000000000000000011111110000000000001111110000000000000000000001
1000000000100000000000011000000000000000111000000000000010000000000000000110000000001111100000000000000000011100000001000000000001111100000000000001000000011110000000000000000000000111110000000000001111110000000001100000000000000000000001100000000000001100000001110000000001
1000000000100001000000011000010000010000000110000001000000000100000001000000011000010000010000001000010000000011100000001010000001000110000000100000010001000011110000001000000000000110000010000000111000001000011000001100000010000000000110000000100000011000000010000010000101
1000000000000000100000000000011000000000000000111000000000000000100000000000000110000000000000000000000000001110000000000000000000111110000000000000000000000000000000000000000000000000001111111111111000000000000000000000000000011111110000000000001111110000000000000000000001
1000000000100000000000011000000000000000111000000000000000100000000000000110000000001111100000000000000000011100000001000000000001111100000000000001000000011110000000000000000000000111110000000000001111110000000001100000000000000000000001100000000000001100000001110000000001
1000000000100001000000011000010000010000000110000001000000000100000001000000011000010000010000001000010000000011100000001010000001000110000000100000010001000011110000001000000000000110000010000000111000001000011000001100000010000000000110000000100000011000000010000010000101
1000000000000000100000000000011000000000000000111000000000000000100000000000000110000000000000000000000000001110000000000000000000111110000000000000000000000000000000000000000000000000001111111111111000000000000000000000000000011111110000000000001111110000000000000000000001
1000000000100000000000011000000000000000111000000000000000100000000000000110000000001111100000000000000000011100000001000000000001111100000000000001000000011110000000000000000000000111110000000000001111110000000001100000000000000000000001100000000000001100000001110000000001
1000000000100001000000011000010000010000000110000001000000000100000001000000011000010000010000001000010000000011100000001010000001000110000000100000010001000011110000001000000000000110000010000000111000001000011000001100000010000000000110000000100000011000000010000010000101
1000000000000000100000000000011000000000000000111000000000000000100000000000000110000000000000000000000000001110000000000000000000111110000000000000000000000000000000000000000000000000001111111111111000000000000000000000000000011111110000000000001111110000000000000000000001
1000000000100000000000011000000000000000111000000000000000100000000000000110000000001111100000000000000000011100000001000000000001111100000000000001000000011110000000000000000000000111110000000000001111110000000001100000000000000000000001100000000000001100000001110000000001
1000000000100001000000011000010000010000000110000001000000000100000001000000011000010000010000001000010000000011100000001010000001000110000000100000010001000011110000001000000000000110000010000000111000001000011000001100000010000000000110000000100000011000000010000010000101
1000000000000000100000000000011000000000000000111000000000000000100000000000000110000000000000000000000000001110000000000000000000111110000000000000000000000000000000000000000000000000001111111111111000000000000000000000000000011111110000000000001111110000000000000000000001
1000000000100000000000011000000000000000111000000000000000100000000000000110000000001111100000000000000000011100000001000000000001111100000000000001000000011110000000000000000000000111110000000000001111110000000001100000000000000000000001100000000000001100000001110000000001
1000000000100001000000011000010000010000000110000001000000000100000001000000011000010000010000001000010000000011100000001010000001000110000000100000010001000011110000001000000000000110000010000000111000001000011000001100000010000000000110000000100000011000000010000010000101
1000000000000000100000000000011000000000000000111000000000000000100000000000000110000000000000000000000000001110000000000000000000111110000000000000000000000000000000000000000000000000001111111111111000000000000000000000000000011111110000000000001111110000000000000000000001
1000000000100000000000011000000000000000111000000000000000100000000000000110000000001111100000000000000000011100000001000000000001111100000000000001000000011110000000000000000000000111110000000000001111110000000001100000000000000000000001100000000000001100000001110000000001
1000000000100001000000011000010000010000000110000001000000000100000001000000011000010000010000001000010000000011100000001010000001000110000000100000010001000011110000001000000000000110000010000000111000001000011000001100000010000000000110000000100000011000000010000010000101
1000000000000000100000000000011000000000000000111000000000000000100000000000000110000000000000000000000000001110000000000000000000111110000000000000000000000000000000000000000000000000001111111111111000000000000000000000000000011111110000000000001111110000000000000000000001
1000000000100000000000011000000000000000111000000000000000100000000000000110000000001111100000000000000000011100000001000000000001111100000000000001000000011110000000000000000000000111110000000000001111110000000001100000000000000000000001100000000000001100000001110000000001
1000000000100001000000011000010000010000000110000001000000000100000001000000011000010000010000001000010000000011100000001010000001000110000000100000010001000011110000001000000000000110000010000000111000001000011000001100000010000000000110000000100000011000000010000010000101
1000000000000000100000000000011000000000000000111000000000000000100000000000000110000000000000000000000000001110000000000000000000111110000000000000000000000000000000000000000000000000001111111111111000000000000000000000000000011111110000000000001111110000000000000000000001
1000000000100000000000011000000000000000111000000000000000100000000000000110000000001111100000000000000000011100000001000000000001111100000000000001000000011110000000000000000000000111110000000000001111110000000001100000000000000000000001100000000000001100000001110000000001
1000000000100001000000011000010000010000000110000001000000000100000001000000011000010000010000001000010000000011100000001010000001000110000000100000010001000011110000001000000000000110000010000000111000001000011000001100000010000000000110000000100000011000000010000010000101
1000000000000000100000000000011000000000000000111000000000000000100000000000000110000000000000000000000000001110000000000000000000111110000000000000000000000000000000000000000000000000001111111111111000000000000000000000000000011111110000000000001111110000000000000000000001
1000000000100000000000011000000000000000111000000000000000100000000000000110000000001111100000000000000000011100000001000000000001111100000000000001000000011110000000000000000000000111110000000000001111110000000001100000000000000000000001100000000000001100000001110000000001
1000000000100001000000011000010000010000000110000001000000000100000001000000011000010000010000001000010000000011100000001010000001000110000000100000010001000011110000001000000000000110000010000000111000001000011000001100000010000000000110000000100000011000000010000010000101
1000000000000000100000000000011000000000000000111000000000000000100000000000000110000000000000000000000000001110000000000000000000111110000000000000000000000000000000000000000000000000001111111111111000000000000000000000000000011111110000000000001111110000000000000000000001
1000000000100000000000011000000000000000111000000000000000100000000000000110000000001111100000000000000000011100000001000000000001111100000000000001000000011110000000000000000000000111110000000000001111110000000001100000000000000000000001100000000000001100000001110000000001
1000000000100001000000011000010000010000000110000001000000000100000001000000011000010000010000001000010000000011100000001010000001000110000000100000010001000011110000001000000000000110000010000000111000001000011000001100000010000000000110000000100000011000000010000010000101
1000000000000000100000000000011000000000000000111000000000000000100000000000000110000000000000000000000000001110000000000000000000111110000000000000000000000000000000000000000000000000001111111111111000000000000000000000000000011111110000000000001111110000000000000000000001
1000000000100000000000011000000000000000111000000000000000100000000000000110000000001111100000000000000000011100000001000000000001111100000000000001000000011110000000000000000000000111110000000000001111110000000001100000000000000000000001100000000000001100000001110000000001
1000000000100001000000011000010000010000000110000001000000000100000001000000011000010000010000001000010000000011100000001010000001000110000000100000010001000011110000001000000000000110000010000000111000001000011000001100000010000000000110000000100000011000000010000010000101
1000000000000000100000000000011000000000000000111000000000000000100000000000000110000000000000000000000000001110000000000000000000111110000000000000000000000000000000000000000000000000001111111111111000000000000000000000000000011111110000000000001111110000000000000000000001
1000000000100000000000011000000000000000111000000000000000100000000000000110000000001111100000000000000000011100000001000000000001111100000000000001000000011110000000000000000000000111110000000000001111110000000001100000000000000000000001100000000000001100000001110000000001
1000000000100001000000011000010000010000000110000001000000000100000001000000011000010000010000001000010000000011100000001010000001000110000000100000010001000011110000001000000000000110000010000000111000001000011000001100000010000000000110000000100000011000000010000010000101
1111111111111111111111111111111111111111111111111111111111111111111111111111111111111111111111111111111111111111111111111111111111111111111111111111111111111111111111111111111111111111111111111111111111111111111111111111111111111111111111111111111111111111111111111111111111