NO ./path_to_the_north_texture.png
SO ./path_to_the_south_texture.png
EA ./path_to_the_east_texture.xmp
WE ./path_to_the_west_texture.png


F 220,100,0
C 225,30,0

111111111111
111111001111111
110000000000000111
11000N0010000011
1110000000010011
110100100000011
1100110000000011
11000000000011
110000000000011
1100001100011
111111111111
111111111111