NO ./path_to_the_north_texture.png
SO ./path_to_the_south_texture.png
EA ./path_to_the_east_texture.png
WE ./path_to_the_west_texture.png

F 220,100,0
C 225,30,0

1111111111111111111111111111111111111111111111111111111111111111111111111111111111111111111111111111111111111111111111111111111111111111111111111111111111111111111111111111111111111111111111111111111111111111111111111111111111111111111111111111111111111111111111111111111111
1000000000000000100000000000011000000000000000111000000000000000100000000000000110000000000000000000000000001110000000000000000000111110000000000000000000000000000000000000000000000000001111111111111000000000000000000000000000011111110000000000001111110000000000000000000001
1000000000100000000000011000000000000000111000000000000000100000000000000110000000001111100000000000000000011100000001000000000001111100000000000001000000011110000000000000000000000111110000000000000000000000000001100000000000000000000001100000000000001100000001110000000001
1000000000100001000000011000010000010000000110000001000000000100000001000000011000010000010000001000010000000011100000001010000001000110000000100000010001000011110000001000000000000110000010000000111000001000011000001100000010000000000110000000100000011000000010000010000101
1000000000000000100000000000011000000000000000111000000000000000100000000000000110000000000000000000000000001110000000000000000000000000000000000000000000000000000000000000000000000000000001111111111000000000000000000000000000011111110000000000001111110000000000000000000001
1000000000100000000000011000000000000000111000000000000000100000000000000110000000001111100000000000000000011100000001000000000001111100000000000001000000011110000000000000000000000111110000000000001111110000000001100000000000000000000001100000000000000000000001110000000001
1000000000100001000000011000010000010000000110000001000000000100000001000000011000010000010000001000010000000011100000001010000001000110000000100000010001000011110000001000000000000110000010000000111000001000011000001100000010000000000110000000100000011000000010000010000101
1000000000000000100000000000011000000000000000111000000000000000100000000000000110000000000000000000000000001110000000000000000000111110000000000000000000000000000000000000000000000000001111111111111000000000000000000000000000011111110000000000001111110000000000000000000001
1000000000100000000000011000000000000000111000000000000000100000000000000110000000001111100000000000000000011100000001000000000001111100000000000001000000011110000000000000000000000111110000000000001111110000000001100000000000000000000001100000000000001100000001110000000001
1000000000100001000000011000010000010000000110000001000000000100000001000000011000010000010000001000010000000011100000001010000001000110000000100000010001000011110000001000000000000110000010000000111000001000011000001100000010000000000110000000100000011000000010000010000101
1000000000000000100000000000011000000000000000111000000000000000100000000000000110000000000000000000000000001110000000000000000000111110000000000000000000000000000000000000000000000000001111111111111000000000000000000000000000011111110000000000001111110000000000000000000001
1000000000100000000000011000000000000000111000000000000000100000000000000110000000001111100000000000000000011100000001000000000001111100000000000001000000011110000000000000000000000111110000000000001111110000000001100000000000000000000001100000000000001100000001110000000001
1000000000100001000000011000010000010000000110000001000000000100000001000000011000010000010000001000010000000011100000001010000001000110000000100000010001000011110000001000000000000110000010000000111000001000011000001100000010000000000110000000100000011000000010000010000101
1000000000000000100000000000011000000000000000111000000000000000100000000000000110000000000000000000000000001110000000000000000000111110000000000000000000000000000000000000000000000000001111111111111000000000000000000000000000011111110000000000001111110000000000000000000001
1000000000100000000000011000000000000000111000000000000000100000000000000110000000001111100000000000000000011100000001000000000001111100000000000001000000011110000000000000000000000111110000000000001111110000000001100000000000000000000001100000000000001100000001110000000001
1000000000100001000000011000010000010000000110000001000000000100000001000000011000010000010000001000010000000000000000001010000001000110000000100000010001000011110000001000000000000110000010000000111000001000011000001100000010000000000110000000100000011000000010000010000101
10000000000000001000000000000110000000000000001110000000000000001000000000000001100000000000000000N0000000001110000000000000000000111110000000000000000000000000000000000000000000000000001111111111111000000000000000000000000000011111110000000000001111110000000000000000000001
1000000000100000000000011000000000000000111000000000000000100000000000000110000000001111100000000000000000011100000001000000000001111100000000000001000000011110000000000000000000000111110000000000001111110000000001100000000000000000000001100000000000001100000001110000000001
1000000000100001000000011000010000010000000110000001000000000100000001000000011000010000010000001000010000000011100000001010000001000110000000100000010001000011110000001000000000000110000010000000111000001000011000001100000010000000000110000000100000011000000010000010000101
1000000000000000100000000000011000000000000000111000000000000000100000000000000110000000000000000000000000001110000000000000000000111110000000000000000000000000000000000000000000000000001111111111111000000000000000000000000000011111110000000000001111110000000000000000000001
1000000000100000000000011000000000000000111000000000000000100000000000000110000000001111100000000000000000011100000001000000000001111100000000000001000000011110000000000000000000000111110000000000001111110000000001100000000000000000000001100000000000001100000001110000000001
1000000000100001000000011000010000010000000110000001000000000100000001000000011000010000010000001000010000000011100000001010000001000110000000100000010001000011110000001000000000000110000010000000111000001000011000001100000010000000000110000000100000011000000010000010000101
1000000000000000100000000000011000000000000000111000000000000000100000000000000110000000000000000000000000001110000000000000000000111110000000000000000000000000000000000000000000000000001111111111111000000000000000000000000000011111110000000000001111110000000000000000000001
1000000000100000000000011000000000000000111000000000000000100000000000000110000000001111100000000000000000011100000001000000000001111100000000000001000000011110000000000000000000000111110000000000001111110000000001100000000000000000000001100000000000001100000001110000000001
1000000000100001000000011000010000010000000110000001000000000100000001000000011000010000010000001000010000000011100000001010000001000110000000100000010001000011110000001000000000000110000010000000111000001000011000001100000010000000000110000000100000011000000010000010000101
1000000000000000100000000000011000000000000000111000000000000000100000000000000110000000000000000000000000001110000000000000000000111110000000000000000000000000000000000000000000000000001111111111111000000000000000000000000000011111110000000000001111110000000000000000000001
1000000000100000000000011000000000000000111000000000000000100000000000000110000000001111100000000000000000011100000001000000000001111100000000000001000000011110000000000000000000000111110000000000001111110000000001100000000000000000000001100000000000001100000001110000000001
1000000000100001000000011000010000010000000110000001000000000100000001000000011000010000010000001000010000000011100000001010000001000110000000100000010001000011110000001000000000000110000010000000111000001000011000001100000010000000000110000000100000011000000010000010000101
1000000000000000100000000000011000000000000000111000000000000000100000000000000110000000000000000000000000001110000000000000000000111110000000000000000000000000000000000000000000000000001111111111111000000000000000000000000000011111110000000000001111110000000000000000000001
1000000000100000000000011000000000000000111000000000000000100000000000000110000000001111100000000000000000011100000001000000000001111100000000000001000000011110000000000000000000000111110000000000001111110000000001100000000000000000000001100000000000001100000001110000000001
1000000000100001000000011000010000010000000110000001000000000100000001000000011000010000010000001000010000000011100000001010000001000110000000100000010001000011110000001000000000000110000010000000111000001000011000001100000010000000000110000000100000011000000010000010000101
1000000000000000100000000000011000000000000000111000000000000000100000000000000110000000000000000000000000001110000000000000000000111110000000000000000000000000000000000000000000000000001111111111111000000000000000000000000000011111110000000000001111110000000000000000000001
1000000000100000000000011000000000000000111000000000000000100000000000000110000000001111100000000000000000011100000001000000000001111100000000000001000000011110000000000000000000000111110000000000001111110000000001100000000000000000000001100000000000001100000001110000000001
1000000000100001000000011000010000010000000110000001000000000100000001000000011000010000010000001000010000000011100000001010000001000110000000100000010001000011110000001000000000000110000010000000111000001000011000001100000010000000000110000000100000011000000010000010000101
1000000000000000100000000000011000000000000000111000000000000000100000000000000110000000000000000000000000001110000000000000000000111110000000000000000000000000000000000000000000000000001111111111111000000000000000000000000000011111110000000000001111110000000000000000000001
1000000000100000000000011000000000000000111000000000000000100000000000000110000000001111100000000000000000011100000001000000000001111100000000000001000000011110000000000000000000000111110000000000001111110000000001100000000000000000000001100000000000001100000001110000000001
1000000000100001000000011000010000010000000110000001000000000100000001000000011000010000010000001000010000000011100000001010000001000110000000100000010001000011110000001000000000000110000010000000111000001000011000001100000010000000000110000000100000011000000010000010000101
1000000000000000100000000000011000000000000000111000000000000000100000000000000110000000000000000000000000001110000000000000000000111110000000000000000000000000000000000000000000000000001111111111111000000000000000000000000000011111110000000000001111110000000000000000000001
1000000000100000000000011000000000000000111000000000000000100000000000000110000000001111100000000000000000011100000001000000000001111100000000000001000000011110000000000000000000000111110000000000001111110000000001100000000000000000000001100000000000001100000001110000000001
1000000000100001000000011000010000010000000110000001000000000100000001000000011000010000010000001000010000000011100000001010000001000110000000100000010001000011110000001000000000000110000010000000111000001000011000001100000010000000000110000000100000011000000010000010000101
1000000000000000100000000000011000000000000000111000000000000000100000000000000110000000000000000000000000001110000000000000000000111110000000000000000000000000000000000000000000000000001111111111111000000000000000000000000000011111110000000000001111110000000000000000000001
1000000000100000000000011000000000000000111000000000000000100000000000000110000000001111100000000000000000011100000001000000000001111100000000000001000000011110000000000000000000000111110000000000001111110000000001100000000000000000000001100000000000001100000001110000000001
1000000000100001000000011000010000010000000110000001000000000100000001000000011000010000010000001000010000000011100000001010000001000110000000100000010001000011110000001000000000000110000010000000111000001000011000001100000010000000000110000000100000011000000010000010000101
1000000000000000100000000000011000000000000000111000000000000000100000000000000110000000000000000000000000001110000000000000000000111110000000000000000000000000000000000000000000000000001111111111111000000000000000000000000000011111110000000000001111110000000000000000000001
1000000000100000000000011000000000000000111000000000000000100000000000000110000000001111100000000000000000011100000001000000000001111100000000000001000000011110000000000000000000000111110000000000001111110000000001100000000000000000000001100000000000001100000001110000000001
1000000000100001000000011000010000010000000110000001000000000100000001000000011000010000010000001000010000000011100000001010000001000110000000100000010001000011110000001000000000000110000010000000111000001000011000001100000010000000000110000000100000011000000010000010000101
1000000000000000100000000000011000000000000000111000000000000000100000000000000110000000000000000000000000001110000000000000000000111110000000000000000000000000000000000000000000000000001111111111111000000000000000000000000000011111110000000000001111110000000000000000000001
1000000000100000000000011000000000000000111000000000000000100000000000000110000000001111100000000000000000011100000001000000000001111100000000000001000000011110000000000000000000000111110000000000001111110000000001100000000000000000000001100000000000001100000001110000000001
1000000000100001000000011000010000010000000110000001000000000100000001000000011000010000010000001000010000000011100000001010000001000110000000100000010001000011110000001000000000000110000010000000111000001000011000001100000010000000000110000000100000011000000010000010000101
1000000000000000100000000000011000000000000000111000000000000000100000000000000110000000000000000000000000001110000000000000000000111110000000000000000000000000000000000000000000000000001111111111111000000000000000000000000000011111110000000000001111110000000000000000000001
1000000000100000000000011000000000000000111000000000000000100000000000000110000000001111100000000000000000011100000001000000000001111100000000000001000000011110000000000000000000000111110000000000001111110000000001100000000000000000000001100000000000001100000001110000000001
1000000000100001000000011000010000010000000110000001000000000100000001000000011000010000010000001000010000000011100000001010000001000110000000100000010001000011110000001000000000000110000010000000111000001000011000001100000010000000000110000000100000011000000010000010000101
1000000000000000100000000000011000000000000000111000000000000000100000000000000110000000000000000000000000001110000000000000000000111110000000000000000000000000000000000000000000000000001111111111111000000000000000000000000000011111110000000000001111110000000000000000000001
1000000000100000000000011000000000000000111000000000000000100000000000000110000000001111100000000000000000011100000001000000000001111100000000000001000000011110000000000000000000000111110000000000001111110000000001100000000000000000000001100000000000001100000001110000000001
1000000000100001000000011000010000010000000110000001000000000100000001000000011000010000010000001000010000000011100000001010000001000110000000100000010001000011110000001000000000000110000010000000111000001000011000001100000010000000000110000000100000011000000010000010000101
1111111111111111111111111111111111111111111111111111111111111111111111111111111111111111111111111111111111111111111111111111111111111111111111111111111111111111111111111111111111111111111111111111111111111111111111111111111111111111111111111111111111111111111111111111111111