NO ./path_to_the_north_texture.png
SO ./path_to_the_south_texture.png
EA ./path_to_the_east_texture.xmp
WE ./path_to_the_west_texture.png


F 220,100,0
C 225,30,0

111111111111
111111111111
110000000111
11000N001011
111000010011
110100100011
110011000011
110000000011
110000000011
110000110011
111111111111
111111111111