NO ./textures/north.png
SO ./textures/south.png
EA ./textures/east.png
WE ./textures/west.png

F 220,100,0
C 225,30,0

        1111111111111111111111111
        1000000000110000000000001
        1011000001110000000000001
        1001000000000000000000011
111111111011000001110000000000001
100000000011000001110111110111111
11110010000000000000000110001
11110100000010000000010011001
110000000001000000000000011001
10000000N00000000000000000001
100000000000000000000000010001
1100000111010101111101111000111
11110111 1110101 101111010001
11111111 1111111 111111111111
