NO ./path_to_the_north_texture.png
SO ./path_to_the_south_texture.png
EA ./path_to_the_east_texture.xmp
WE ./path_to_the_west_texture.png

F 220,100,0
C 225,30,0

        1111111111111111111111111
        1000000000110000000000001
        1011000001110000000D00001
        1001000000000000000000001
111111111011000001110000000000001
100000000011000001110111110111111
11110111111111011100000010001
11110111111111011101010010001
11000000110101011100000010001
10000000000000001100000000001
10000000N00000001101010010001
1100000111010101111101111000111
11110111 1110101 101111010001
11111111 1111111 111111111111

111111111111
111111001111111
110000000000000111
11000N0010000011
1110000000010011
110100100000011
1100110000000011
11000000000011
110000000000011
1100001100011
111111111111
111111111111